SSSSSSSSSSSSSSSSSSSSSSS
S----------S----------S
S+SSS-SSSS-S-SSSS-SSS+S
S---------------------S
S-SSS-S-SSSSSSS-S-SSS-S
S-----S----S----S-----S
SSSSS-SSSS0S0SSSS-SSSSS
0000S-S000000000S-S0000
0000S-S0000G0000S-S0000
0000S-0000GGG0000-S0000
0000S-S000000000S-S0000
SSSSS-S0SSSSSSS0S-SSSSS
S----------S----------S
S-SSS-SSSS-S-SSSS-SSS-S
S+---------P---------+S
SSSSSSSSSSSSSSSSSSSSSSS